NO textures/north.png

SO textures/south.png

EA 				textures/east.png


F 220,100, 245
C 255, 255, 0


WE textures/west.png                  
                     
	11111111111111111111111111
    111111111111110000000000001111111111
    			1011000001110000000000001111
    111111111111100000000000111111111111
11111111101100000111000000001
10000000001100000111011111111
11110111111111011100000010001
11110111111111011101010010001
11000000110101011100000010001
10000000000000001100000010001
10000000000000001101010010111111111111111111111111
11000001110101011111011111N00000000000000000000001
11110111 1110101 101111010111111111111111111111111
11111111 1111111 111111111111