NO textures/north.png
SO textures/south.png
WE textures/west.png
EA textures/east.png

F 255,255,1
C 0,0,0

                             1111111
        111111111111111111111111111
        100000000011000000000011101
        1011000001110000000001  101
        10010000010000000000001 101
1111111110110000011100000000001 101
1000000000110000011100000111111 111
11110111111111011100000000001
11110111111111011101010010001
11000100110101011100000010001
100010100000000000000000010001
10000100000000001101010010N01
11000000111010101111101101000111
11110111 1110101 111111010001
11111111 1111111 111111111111