1111111111111
10000000000C1
1110011111001
1PE0110100011
1111111111111