1111111111111
1CCCCCCCCCCE1
1CCCCCCCCCCC1
1CCCCCCCCCCC1
1CCCCCCCCCCC1
1PCCCCCCCCCC1
1111111111111