1111111111111
100000000CCE1
1000000CC1111
10000CC111111

100CC11111111
1PC1111111111
1111111111111